Marilène Rousseau	加勒比海
Andile?Ihejirika	中非
Nicodemo Bautista	中美洲
Cansu Peynirci	中亚
Lon Bonher	美国中部
Wasswa?Ahmed	东非
Hadia Bousaid	东亚
Lynne Marchand	加拿大东部
Oxana Lagunov	东欧
Dolores Davis	美国东部
Lindiwe?Afolayan	北非
Miina Nylund	北欧
Kauri Anaru	大洋洲
Vasco Magalh?es	南美
Preecha Metharom	东南亚
Nora Cuijper	南部非洲
Chandrakant Chaudhri	南亚
Gavino Bove	南欧
Flannery Newton	美国南部
Katlego Akosua	西非
Kaoru Xun	西亚
Angela Jephson	西加拿大
Gilbert Wolff	西欧
Derrick Snyders	美国西部
